

C# (유니티)
넷마블네오 - 프로젝트L(나혼자레벨업)
네오위즈 - ProjcectK
데브캣 - 마비노기 모바일
넷게임즈 - 블루아카이브
위메이드커넥트 - 신규
그라비티 - 캐주얼 수집형 RPG
그라비티 네오싸이언 - 라그나로크 The Lost of Memories
111% - 모바일
님블뉴런 - 이터널 리턴
팀42 - 신규 모바일
투핸즈게임즈 - 모바일
트리노드 - 포코팡 등
로그웨이브 - 신규 모바일 MMO
플레이하드 - 모바일
베이글코드 - 캐주얼
기어세컨드(스타트업) - 슬레이어 키우기 등
어비스(스타트업) - 로엠



C++ (언리얼)
엔씨소프트 - 신규 콘솔 슈팅
네오플 - OverKill
넷마블 네오 - 왕좌의 게임
라이온 하트 - 오딘: 발할라 라이징
스마일게이트알피지 - 로스트 아크 모바일
스마일게이트 메가포트 - 신규 모바일
엑스엘게임즈 - 신규 모바일 MMO
아이덴티티게임즈 - 드래곤 네스트
니즈게임즈 - 언디셈버
엔젤게임즈 - 신규 액션 RPG
이브이알스튜디오 - ProjectV(생존 액션 어드벤쳐 RPG)
유비펀스튜디오 - 데카론
멘티스코 - 캐리버스



C++ / C# 둘다 
컴투스 - 모바일
네시삼삽삼분 - 신규 NFT 스포츠
선데이토즈 - 모바일



Cocos2d-x
슈퍼크리에이티브 - 에픽세븐



자체 엔진
넥슨 - 마비노기
슈퍼크리에이티브 - 신규



미기재
슈퍼캣 - 환세취호전
슈퍼캣 - 바람의 나라 연
슈퍼캣 - 그래니의 저택





필요 역량
언어 능력
OOP 이해도


우대 역량
컴퓨터 공학 (CS) 지식
수학, 물리, 2D/3D 그래픽스
메모리 및 성능 최적화
윈도우 프로그래밍
멀티스레드 프로그래밍
윈도우 네트워크 프로그래밍 (IOCP, TCP/IP)
프로젝트 상용화 경험
게임 개발에 필요한 Tool 제작 경험
다양한 오픈소스 활용 경험
유사 장르 게임 플레이 경험